0,0,1,1,1,2,2,2,0,3,1,3,1,6,2,2,0,3,1,3,1,2,2,2,0,3,3,3,1,7,5,2,0,3,3,3,1,7,5,5,0,3,4,3,1,7,5,5,4,3,4,3,1,7,7,5,4,4,4,4,5,5,5,5
4,4,4,4,4,4,8,8,8,4,4,4,4,4,4,4,4,3,4,1,1,1,6,4,4,4,3,4,4,4,4,6,4,4,4,3,4,4,4,4,6,4,4,4,4,4,4,4,4,4,7,7,7,4,4,4,4,4,4,4,0,0,0,4,4,2,2,2,4,4,4,4,4,5,5,5,4,4,4,4,4
5,5,5,5,5,5,5,5,2,2,2,2,2,2,2,2,2,7,2,2,2,2,1,2,7,2,0,2,2,1,6,6,6,0,2,2,6,6,6,6,6,4,2,2,2,4,4,4,4
6,6,1,1,1,1,8,8,6,1,1,4,4,1,1,8,6,1,4,4,4,4,1,8,5,1,4,4,0,4,1,8,5,1,1,4,0,0,1,8,5,5,1,1,1,0,0,8,5,5,5,5,5,7,0,3,5,5,5,7,7,7,3,3
1,1,6,6,4,4,4,4,4,4,1,1,1,6,6,7,7,4,4,4,4,4,1,6,6,0,7,7,4,4,4,5,5,0,0,0,7,7,4,4,4,5,5,0,0,3,3,4,4,4,4,9,5,5,3,3,2,2,4,4,4,9,9,9,3,3,8,2,2,4,4,4,9,9,8,8,8,2,2,4,4,4,4,4,8,8,4,4,4,4,4,4,4,4,4,4,4,4,4,4
8,2,7,7,7,7,4,4,4,8,2,7,2,2,2,2,2,4,8,2,7,2,1,1,1,2,4,8,2,0,2,1,2,1,2,4,3,2,0,2,1,2,6,2,4,3,2,0,2,2,2,6,2,4,3,2,0,0,6,6,6,2,5,3,2,2,2,2,2,2,2,5,3,3,3,5,5,5,5,5,5
2,2,2,2,2,2,2,8,8,2,2,2,3,3,4,4,8,8,2,2,2,3,3,4,4,2,2,2,2,2,2,5,5,2,2,2,2,2,0,0,5,5,2,2,2,2,2,0,0,2,2,7,7,2,2,1,1,6,6,2,7,7,2,2,1,1,6,6,2,2,2,2,2,2,2,2,2,2,2,2,2
7,7,7,7,7,7,7,7,7,7,0,0,0,2,7,7,7,7,0,2,0,2,7,7,1,1,2,2,2,2,4,4,1,6,6,2,2,3,3,4,1,1,6,2,2,2,3,4,5,6,6,5,2,3,3,4,5,5,5,5,2,2,4,4
6,6,6,6,6,3,3,3,3,6,0,6,6,6,5,5,5,3,6,0,4,6,2,5,5,3,3,6,0,4,4,2,5,3,3,3,8,8,2,2,2,2,2,3,8,8,8,8,7,2,1,1,1,8,8,8,7,7,2,8,1,1,8,8,7,7,7,8,8,8,1,8,8,8,8,8,8,8,8,8,8
4,4,4,4,4,4,4,4,4,4,1,1,1,4,5,5,5,4,4,1,1,1,4,5,5,5,3,4,1,1,2,4,4,5,5,3,4,2,2,2,2,4,4,7,7,4,6,6,2,2,2,0,0,7,4,6,6,6,2,0,0,0,7,4,6,6,6,7,0,0,0,7,4,8,8,7,7,7,7,7,7
9,9,9,9,0,5,5,5,5,5,2,7,4,4,0,3,5,6,6,6,2,7,4,4,0,3,5,5,3,6,2,7,4,4,0,3,3,3,3,6,2,2,4,4,0,2,6,6,3,6,2,2,4,4,0,2,8,6,6,6,2,2,4,4,2,2,8,8,6,8,2,2,2,2,2,8,8,8,6,8,1,1,1,2,2,8,8,8,6,8,1,1,1,2,2,8,8,8,8,8
4,4,4,4,4,0,0,0,0,4,4,1,4,5,0,0,6,0,4,1,1,1,5,5,6,6,6,4,4,1,4,5,5,4,6,4,7,4,4,4,4,4,4,4,4,7,7,3,4,2,4,4,8,4,7,3,3,3,2,2,8,8,8,7,7,3,7,2,7,7,8,7,7,7,7,7,7,7,7,7,7
2,2,7,7,2,2,2,2,5,2,7,7,3,3,3,2,5,2,7,7,3,3,3,2,5,2,2,2,2,2,6,2,4,4,0,0,0,2,6,2,4,4,2,2,2,2,6,2,4,4,2,2,2,2,2,2,1,1,1,2,2,2,2,2
2,2,2,6,6,2,3,3,5,2,8,8,8,6,2,3,5,5,2,8,6,6,6,2,3,3,3,2,8,8,2,2,2,7,7,7,2,2,2,2,2,2,7,2,7,2,2,2,2,1,2,2,2,7,4,4,4,2,1,2,1,2,2,4,0,0,2,1,1,1,2,2,4,4,0,2,2,2,2,2,2
2,2,2,2,2,2,2,2,9,9,2,2,2,2,2,3,3,7,7,9,2,2,2,2,0,0,3,7,9,9,2,8,8,2,0,3,3,7,7,9,2,8,2,2,0,0,3,7,5,5,2,8,8,6,0,6,2,2,2,5,2,8,2,6,6,6,6,2,5,5,2,2,2,2,2,2,2,2,2,5,2,1,2,1,2,2,2,4,2,4,1,1,1,1,2,2,4,4,4,4
0,0,0,8,8,8,8,8,8,0,6,0,3,3,8,3,3,8,0,6,6,3,3,3,3,3,8,1,1,1,2,7,2,3,3,8,1,1,1,2,7,2,8,8,8,1,1,1,2,2,2,8,8,8,1,1,1,1,1,1,5,5,4,1,1,1,1,1,1,4,5,4,1,1,1,1,1,1,4,4,4
